9 9 3 5 700 800
1 1 1 1 2 Ap......
8 1 1 1 2 AP......
3 1 1 1 0 AG......
8 8 1 1 3 W.......
1 8 1 1 1 DG......

111111111
110111101
110111101
110111101
100000000
111101111
111101111
111101111
111101111

111111111
10000000c
10000000b
120000b0b
100000000
100000000
1p0000000
100000000
1B000000B

111111111
100000000
100000000
100000000
100000000
100000000
100000000
100000000
100000000