9 9 3 1 680 900
1 1 1 1 1 AWPpDG..


111111111
111111111
111111111
111111111
100000000
111101111
111101111
111101111
111101111

111111111
10000P00c
100000000
100000002
100000000
100000000
100000000
100000000
1b000200b

111111111
100000000
100000000
100000000
100000000
100000000
100000000
100000000
100000000