10 10 3 2 750 1000
1 1 1 1 1 AWPpDG..
9 9 1 1 3 AWPpDG..


1111111111
1111101111
1111101111
1111101111
1111101111
1111101111
1111101111
1111101111
1111101111
1111101111

1111111111
1000000000
1000000000
1000000000
1000000000
1p00000000
1000000000
1000000000
1000000000
1bbbc02000

1111111111
1000000000
1000000000
1000000000
1000000000
1000000000
1000000000
1000000000
1000000000
1000000000