10 10 3 2 750 1000
1 1 1 1 1 AWPpDG..
9 9 1 1 1 AWPpDG..

1111111111
1111111111
1111110111
1111110111
1111110111
1111110111
1111110000
1111111111
1100001001
1111111101

1111111111
100000P00c
1000000000
1000000000
1000000000
1000000b0b
1000000000
1000000000
1000002000
10000b0T00

1111111111
1000000000
1000000000
1000000000
1000000000
1000000000
1000000000
1000000000
1000000000
1000000000